C C C C C
C A C C C
C A C A C
C A C C C
C C C C C