T A T T T
T A T T T
T T T A T
T T T T T
T T T T T