T T T T T T
T T T T A T
T T T T A T
T T A T A T
T T A T A T
T T A T T T