A A T T T T T T T T T T T T T T
T T T T T A T T T T T T T T T T
T T T T T A T T T T T T T T T T
A A T T T A T T T T T T T T T T
A A T T T A T T T T T T T T T T
A A T T T T T T T T T T T T T T
A A T T T T T T T T T T T T T T
A A T T T T T T T T T T T T T T
A A T T T T T T T T T T T T T T
A A T T T T T T T T T T T T T T
A A T T T T T T T T T T T T T T
A A T T T T T T A A A A A A T T
A A T T T T T T T T T T T T T T
A A T T T T T T T T T T T T T T