X X X X X
X X X X G
P X G X T
T X X X G
X X X X X