X X C C C C C C C C C C C C C C
P X X X X X X X X X G X X X X C
G X T X X X X X T X X X X X X C
X X C X X X X X C C X X C X X C
X X C X X X X X C X X X C X T C
X X C C C C C C C X X C C C C C
X X C X X X X X X X X C X X X G
X X C X X X X X X T X C X X X G
X X C X X C C C C C C C X X C C
X X C X X C X X X X X X X X C C
X X C X X C X X X X X X T X C C
X X C X X G X X X X X X X X C C
X X C X X T X X C C C C C C C C
X X C C C C C C C C C C C C C C